25 25 44 25 48 46 46 46 44 44 25 25 25 25 44 25 25 25 25 25 46 25 46 46 48 25 25 25 47 25 25 25 25 25 25 25 45 44 46 48 46 46 46 25 25 25 25 25 25 25
01 01 01 01 01 01 01 01 01 01 01 01 01 02 25 45 25 47 25 00 02 25 45 25 25 47 45 25 48 25 25 25 25 25 44 60 46 44 44 25 25 25 45 47 25 25 45 25 25 25
10 04 04 04 04 04 04 04 04 04 04 04 04 05 45 46 25 48 25 03 05 44 46 25 25 48 46 44 25 00 01 01 01 01 01 01 01 01 01 02 44 44 46 48 25 25 46 25 25 25 
06 10 04 04 04 04 04 04 04 04 04 04 04 05 46 47 25 25 44 03 05 25 25 44 44 44 25 00 01 12 04 04 04 04 04 04 04 04 04 11 01 02 44 25 44 45 45 25 25 25 
25 03 04 04 04 04 04 04 04 04 04 04 04 05 25 48 00 01 01 12 11 01 01 01 01 01 01 12 04 04 04 04 04 04 04 04 04 04 04 04 04 11 01 02 25 46 46 25 45 25 
25 03 04 04 04 04 04 04 04 04 04 04 04 05 44 44 03 04 04 04 04 04 04 04 04 04 04 09 07 07 07 07 10 04 04 04 04 49 04 04 04 04 04 18 16 47 47 25 46 47 
25 06 10 04 04 04 04 04 04 04 04 04 04 05 44 25 03 04 04 04 04 04 04 04 04 04 04 05 44 47 45 44 06 10 04 04 04 04 04 04 04 04 04 05 44 48 48 44 25 48 
45 44 06 10 04 04 04 04 04 04 04 04 04 05 47 45 06 10 04 09 07 07 07 07 07 10 09 08 25 48 46 25 44 03 04 04 04 04 04 04 04 04 04 11 01 01 01 01 02 44 
46 25 60 03 04 04 04 04 04 04 04 04 04 05 48 46 25 03 04 05 25 44 25 25 25 38 39 25 25 25 44 45 47 06 10 04 04 04 04 04 04 04 09 07 07 07 07 07 08 44 
25 00 01 12 04 04 04 04 04 04 04 04 04 05 44 00 01 12 04 05 47 25 44 25 00 12 11 01 02 25 25 46 48 44 06 07 07 07 07 10 04 04 05 44 25 45 25 25 25 25
25 03 04 04 04 04 04 04 04 04 04 04 04 05 25 03 04 04 04 05 48 45 45 25 03 04 04 04 11 02 44 25 25 44 45 45 47 44 44 06 10 04 11 01 02 46 25 25 45 25 
25 06 07 07 07 07 07 10 09 07 07 07 07 08 47 06 10 09 07 08 25 46 46 25 03 04 04 04 04 11 02 44 25 47 46 46 48 25 44 47 06 10 04 04 18 16 47 45 46 47 
25 44 25 25 44 25 25 34 35 44 25 25 25 44 48 44 03 05 25 25 44 44 47 25 03 04 04 04 04 04 11 02 25 48 25 47 25 44 25 48 25 06 10 04 05 25 48 46 25 48 
44 00 01 01 01 01 01 12 11 01 01 01 01 01 01 01 12 11 02 25 44 47 48 25 03 04 04 04 04 04 04 11 02 25 25 48 45 25 45 44 45 44 06 10 05 44 47 45 25 45 
25 03 04 04 04 04 04 04 04 04 04 04 04 04 04 04 04 04 11 01 02 48 25 25 06 10 04 04 04 49 04 04 11 02 44 25 46 45 46 45 46 25 25 40 41 25 48 46 44 46 
44 03 04 49 04 04 04 04 04 04 04 04 04 04 04 04 04 04 04 04 05 44 45 45 25 03 04 04 04 04 04 04 04 11 02 47 25 46 47 46 25 45 44 03 11 02 25 25 25 25 
44 03 04 04 04 04 04 04 04 04 04 04 09 07 07 07 10 04 04 04 05 44 46 46 44 03 04 04 04 04 04 04 04 04 05 48 25 25 48 47 25 46 25 03 04 05 25 45 25 25 
25 03 04 04 04 04 04 04 04 04 04 04 05 25 45 25 03 04 04 04 05 25 25 47 25 03 04 04 04 04 04 04 04 04 05 25 25 44 25 48 45 25 44 03 04 05 47 46 25 25 
47 03 04 04 04 04 04 04 04 04 04 04 05 44 46 47 03 04 04 04 05 44 25 48 15 20 04 04 04 04 04 04 04 04 11 02 44 25 44 25 46 44 44 03 04 05 48 25 25 25 
48 03 04 04 04 04 04 04 04 04 04 04 05 44 60 48 03 04 04 04 05 25 45 25 25 03 04 04 04 04 04 04 04 04 09 08 25 44 45 44 44 25 44 03 04 05 44 25 25 25 
25 03 04 99 04 04 04 04 04 04 04 04 11 01 01 01 12 04 04 04 05 25 46 25 47 06 10 04 04 04 04 04 04 09 08 45 25 45 46 47 45 45 47 03 04 05 47 45 25 25 
25 03 04 04 04 04 04 04 04 04 04 04 04 04 04 04 04 04 04 04 05 47 44 25 48 44 06 10 04 04 04 04 09 08 25 46 47 46 25 48 46 46 48 03 04 05 48 46 25 25 
25 03 04 04 04 04 04 04 04 04 04 04 04 04 04 04 04 04 04 09 08 48 45 45 25 25 44 03 04 04 09 07 08 44 47 44 48 44 47 45 45 25 00 12 09 08 44 25 44 25 
25 06 07 07 07 07 10 09 07 07 07 07 07 07 07 07 07 07 07 08 44 44 46 46 45 25 25 06 10 09 08 47 45 45 48 25 25 25 48 46 46 00 12 04 05 44 45 45 25 25
45 44 45 47 25 44 36 37 25 25 25 44 44 45 44 25 44 44 44 47 25 25 45 45 46 25 44 44 06 08 44 48 46 46 25 45 25 25 47 47 44 03 04 04 05 25 46 46 25 25
25 45 46 48 44 25 03 05 25 25 44 44 45 46 25 25 45 44 45 48 25 25 46 46 25 45 25 25 44 44 25 45 45 44 45 46 25 45 48 48 25 03 04 04 11 02 25 25 45 25
25 46 25 00 01 01 12 11 01 01 02 44 46 44 25 44 46 25 46 25 25 25 25 25 25 46 25 25 25 25 25 46 46 44 46 25 25 46 44 00 01 12 04 04 04 18 16 44 46 25
25 25 00 12 04 04 04 04 04 04 11 01 02 25 44 25 47 45 45 45 47 44 25 25 25 25 44 25 25 25 25 25 44 25 44 25 44 44 00 12 04 04 04 09 07 08 25 25 25 25 
25 00 12 04 04 04 04 04 04 04 04 04 11 02 44 25 48 46 46 46 48 25 25 00 01 01 01 01 01 01 01 01 01 01 01 01 01 01 12 04 04 04 09 08 47 44 47 45 25 25
25 03 04 04 04 04 04 04 04 04 04 04 04 05 25 47 47 45 44 45 45 25 25 06 10 04 04 04 04 04 04 04 04 04 04 04 04 04 04 04 04 04 05 47 48 25 48 46 25 25
25 03 04 04 04 04 04 04 04 04 04 04 04 05 25 48 48 46 44 46 46 25 44 25 06 10 04 49 04 04 04 04 04 04 04 04 04 04 04 04 04 04 05 48 60 44 25 25 45 25
25 06 10 04 04 04 04 04 04 04 04 04 04 05 44 25 44 25 45 47 25 44 47 25 25 03 04 04 04 04 04 04 04 04 04 04 04 04 04 04 04 04 11 01 01 01 02 44 46 25
25 45 06 10 04 04 04 04 04 04 04 04 04 11 01 01 01 02 46 48 44 25 48 44 00 12 04 04 04 04 04 04 04 04 04 04 04 49 04 04 04 04 04 04 04 04 11 02 25 25
44 46 44 06 10 04 04 04 04 04 09 07 07 10 04 04 04 05 25 25 25 25 25 00 12 04 04 04 04 04 04 04 04 04 04 04 04 04 04 04 04 04 04 04 04 04 04 11 02 25
44 45 44 47 06 10 04 04 04 09 08 47 25 03 04 49 04 11 02 44 45 25 15 20 04 04 04 04 04 04 04 04 04 04 04 04 04 04 04 04 04 04 04 09 07 07 07 07 08 25
25 46 44 48 44 06 10 04 09 08 44 48 44 03 04 04 04 04 05 25 46 25 25 06 07 07 10 04 04 04 04 04 04 04 04 04 04 04 09 07 07 07 07 08 44 45 47 25 25 25
25 25 47 47 47 47 06 19 08 47 25 44 25 03 04 09 07 07 08 44 45 47 44 25 44 44 06 10 04 04 04 04 04 09 07 07 07 07 08 44 47 45 44 25 25 46 48 45 44 25
25 25 48 48 48 48 44 13 45 48 25 25 44 06 07 08 44 45 44 47 46 48 25 44 45 47 44 06 07 07 10 09 07 08 44 45 25 25 44 45 48 46 25 25 25 45 25 46 45 25
25 25 25 25 25 25 25 45 46 44 25 25 25 25 44 25 25 46 25 48 25 25 44 25 46 48 25 25 47 25 42 43 25 25 25 46 44 25 25 46 25 25 25 25 25 46 25 25 46 25 
25 25 25 25 25 25 25 46 25 25 25 25 25 25 25 25 25 25 25 25 25 25 25 44 25 25 25 25 48 25 25 25 25 25 25 25 25 25 25 25 25 25 25 25 25 25 25 25 25 25