25 25 25 25 25 25 25 25 25 25 25 25 25 25 25 25 25 25 25 25 25 25 25 25 25 25 25 25 25 25 25 25 25 25 25 25 25 25 25 25 25 25 25 25 25 25 25 25 25 25
01 01 01 01 01 01 01 01 01 01 01 01 01 02 25 25 25 25 25 00 02 25 25 25 25 25 25 25 25 25 25 25 25 25 25 25 25 25 25 25 25 25 25 25 25 25 25 25 25 25
10 04 04 04 04 04 04 04 04 04 04 04 04 05 25 25 25 25 25 03 05 25 25 25 25 25 25 25 25 00 01 01 01 01 01 01 01 01 01 02 25 25 25 25 25 25 25 25 25 25 
06 10 04 04 04 04 04 04 04 04 04 04 04 05 25 25 25 25 25 03 05 25 25 25 25 25 25 00 01 12 04 04 04 04 04 04 04 04 04 11 01 02 25 25 25 25 25 25 25 25 
25 03 04 04 04 04 04 04 04 04 04 04 04 05 25 25 00 01 01 12 11 01 01 01 01 01 01 12 04 04 04 04 04 04 04 04 04 04 04 04 04 11 01 02 25 25 25 25 25 25 
25 03 04 04 04 04 04 04 04 04 04 04 04 05 25 25 03 04 04 04 04 04 04 04 04 04 04 09 07 07 07 07 10 04 04 04 04 04 04 04 04 04 04 18 16 25 25 25 25 25 
25 06 10 04 04 04 04 04 04 04 04 04 04 05 25 25 03 04 04 04 04 04 04 04 04 04 04 05 25 25 25 25 06 10 04 04 04 04 04 04 04 04 04 05 25 25 25 25 25 25 
25 25 06 10 04 04 04 04 04 04 04 04 04 05 25 25 06 10 04 09 07 07 07 07 10 04 04 05 25 25 25 25 25 03 04 04 04 04 04 04 04 04 04 11 01 01 01 01 02 25 
25 25 60 03 04 04 04 04 04 04 04 04 04 05 25 25 25 03 04 05 25 25 25 25 03 04 04 05 25 25 25 25 25 06 10 04 04 04 04 04 04 04 09 07 07 07 07 07 08 25 
25 00 01 12 04 04 04 04 04 04 04 04 04 05 25 00 01 12 04 05 25 25 25 25 03 04 04 11 02 25 25 25 25 25 06 07 07 07 07 10 04 04 05 25 25 25 25 25 25 25
25 03 04 04 04 04 04 04 04 04 04 04 04 05 25 03 04 04 04 05 25 25 25 25 03 04 04 04 11 02 25 25 25 25 25 25 25 25 25 06 10 04 11 01 02 25 25 25 25 25 
25 06 07 07 07 07 10 04 09 07 07 07 07 08 25 03 04 09 07 08 25 25 25 25 03 04 04 04 04 11 02 25 25 25 25 25 25 25 25 25 06 10 04 04 18 16 25 25 25 25 
25 25 25 25 25 25 03 04 05 25 25 25 25 25 25 03 04 05 25 25 25 25 25 25 03 04 04 04 04 04 11 02 25 25 25 25 25 25 25 25 25 06 10 04 05 25 25 25 25 25 
25 00 01 01 01 01 12 04 11 01 01 01 01 01 01 12 04 11 02 25 25 25 25 25 03 04 04 04 04 04 04 11 02 25 25 25 25 25 25 25 25 25 03 04 05 25 25 25 25 25 
25 03 04 04 04 04 04 04 04 04 04 04 04 04 04 04 04 04 11 01 02 25 25 25 06 10 04 04 04 04 04 04 11 02 25 25 25 25 25 25 25 25 06 10 11 02 25 25 25 25 
25 03 04 04 04 04 04 04 04 04 04 04 04 04 04 04 04 04 04 04 05 25 25 25 25 03 04 04 04 04 04 04 04 11 02 25 25 25 25 25 25 25 25 03 04 05 25 25 25 25 
25 03 04 04 04 04 04 04 04 04 04 04 09 07 07 07 10 04 04 04 05 25 25 25 25 03 04 04 04 04 04 04 04 04 05 25 25 25 25 25 25 25 25 03 04 05 25 25 25 25 
25 03 04 04 04 04 04 04 04 04 04 04 05 25 25 25 03 04 04 04 05 25 25 25 25 03 04 04 04 04 04 04 04 04 05 25 25 25 25 25 25 25 25 03 04 05 25 25 25 25 
25 03 04 04 04 04 04 04 04 04 04 04 05 25 25 25 03 04 04 04 05 25 25 25 15 20 04 04 04 04 04 04 04 04 11 02 25 25 25 25 25 25 25 03 04 05 25 25 25 25 
25 03 04 04 04 04 04 04 04 04 04 04 05 25 60 25 03 04 04 04 05 25 25 25 25 03 04 04 04 04 04 04 04 04 09 08 25 25 25 25 25 25 25 03 04 05 25 25 25 25 
25 03 04 04 04 04 04 04 04 04 04 04 11 01 01 01 12 04 04 04 05 25 25 25 25 06 10 04 04 04 04 04 04 09 08 25 25 25 25 25 25 25 25 03 04 05 25 25 25 25 
25 03 04 04 04 04 04 04 04 04 04 04 04 04 04 04 04 04 04 04 05 25 25 25 25 25 06 10 04 04 04 04 09 08 25 25 25 25 25 25 25 25 25 03 04 05 25 25 25 25 
25 03 04 04 04 04 04 04 04 04 04 04 04 04 04 04 04 04 04 09 08 25 25 25 25 25 25 03 04 04 09 07 08 25 25 25 25 25 25 25 25 25 00 12 09 08 25 25 25 25 
25 06 07 07 07 07 10 09 07 07 07 07 07 07 07 07 07 07 07 08 25 25 25 25 25 25 25 06 10 09 08 25 25 25 25 25 25 25 25 25 25 00 12 04 05 25 25 25 25 25
25 25 25 25 25 25 03 05 25 25 25 25 25 25 25 25 25 25 25 25 25 25 25 25 25 25 25 25 06 08 25 25 25 25 25 25 25 25 25 25 25 03 04 04 05 25 25 25 25 25
25 25 25 25 25 25 03 05 25 25 25 25 25 25 25 25 25 25 25 25 25 25 25 25 25 25 25 25 25 25 25 25 25 25 25 25 25 25 25 25 25 03 04 04 11 02 25 25 25 25
25 25 25 00 01 01 12 11 01 01 02 25 25 25 25 25 25 25 25 25 25 25 25 25 25 25 25 25 25 25 25 25 25 25 25 25 25 25 25 00 01 12 04 04 04 18 16 25 25 25
25 25 00 12 04 04 04 04 04 04 11 01 02 25 25 25 25 25 25 25 25 25 25 25 25 25 25 25 25 25 25 25 25 25 25 25 25 25 00 12 04 04 04 09 07 08 25 25 25 25 
25 00 12 04 04 04 04 04 04 04 04 04 11 02 25 25 25 25 25 25 25 25 25 00 01 01 01 01 01 01 01 01 01 01 01 01 01 01 12 04 04 04 09 08 25 25 25 25 25 25
25 03 04 04 04 04 04 04 04 04 04 04 04 05 25 25 25 25 25 25 25 25 25 06 10 04 04 04 04 04 04 04 04 04 04 04 04 04 04 04 04 04 05 25 25 25 25 25 25 25
25 03 04 04 04 04 04 04 04 04 04 04 04 05 25 25 25 25 25 25 25 25 25 25 06 10 04 04 04 04 04 04 04 04 04 04 04 04 04 04 04 04 05 25 25 25 25 25 25 25
25 06 10 04 04 04 04 04 04 04 04 04 04 05 25 25 25 25 25 25 25 25 25 25 25 03 04 04 04 04 04 04 04 04 04 04 04 04 04 04 04 04 11 01 01 01 02 25 25 25
25 25 06 10 04 04 04 04 04 04 04 04 04 11 01 01 01 02 25 25 25 25 25 25 00 12 04 04 04 04 04 04 04 04 04 04 04 04 04 04 04 04 04 04 04 04 11 02 25 25
25 25 25 06 10 04 04 04 04 04 09 07 07 10 04 04 04 05 25 25 25 25 25 00 12 04 04 04 04 04 04 04 04 04 04 04 04 04 04 04 04 04 04 04 04 04 04 11 02 25
25 25 25 25 06 10 04 04 04 09 08 25 25 03 04 04 04 11 02 25 25 25 15 20 04 04 04 04 04 04 04 04 04 04 04 04 04 04 04 04 04 04 04 09 07 07 07 07 08 25
25 25 25 25 25 06 10 04 09 08 25 25 25 03 04 04 04 04 05 25 25 25 25 06 07 07 10 04 04 04 04 04 04 04 04 04 04 04 09 07 07 07 07 08 25 25 25 25 25 25
25 25 25 25 25 25 06 19 08 25 25 25 25 03 04 09 07 07 08 25 25 25 25 25 25 25 06 10 04 04 04 04 04 09 07 07 07 07 08 25 25 25 25 25 25 25 25 25 25 25
25 25 25 25 25 25 25 13 25 25 25 25 25 06 07 08 25 25 25 25 25 25 25 25 25 25 25 06 07 10 04 09 07 08 25 25 25 25 25 25 25 25 25 25 25 25 25 25 25 25
25 25 25 25 25 25 25 25 25 25 25 25 25 25 25 25 25 25 25 25 25 25 25 25 25 25 25 25 25 03 04 05 25 25 25 25 25 25 25 25 25 25 25 25 25 25 25 25 25 25 
25 25 25 25 25 25 25 25 25 25 25 25 25 25 25 25 25 25 25 25 25 25 25 25 25 25 25 25 25 03 04 05 25 25 25 25 25 25 25 25 25 25 25 25 25 25 25 25 25 25