14 14 14 14 14 14 14 14 14 14 14 14 14 14 14 14 14 14 14 14 14 14 14 14 14 14 14 14 14 14 14 14 14 14 14 14 14 14 14 14 14 14 14 14 14 14 14 14 14 14
01 01 01 01 01 01 01 01 01 01 14 14 14 14 14 14 14 14 14 04 04 14 14 14 14 14 14 14 14 14 14 14 14 14 14 14 14 14 14 14 14 14 14 14 14 14 14 14 14 14
04 04 04 04 04 04 04 04 04 04 04 04 04 14 14 14 14 14 14 04 14 14 14 14 14 14 14 14 14 14 14 14 14 14 14 14 14 14 14 14 14 14 14 14 14 14 14 14 14 14 
08 04 04 04 04 04 04 04 04 04 04 04 04 14 14 14 14 14 14 04 14 14 14 14 14 14 14 04 04 14 14 14 14 14 14 14 14 14 14 14 14 14 14 14 14 14 14 14 14 14 
14 04 04 04 04 04 04 04 04 04 04 04 04 14 14 14 04 04 04 04 04 04 04 04 04 04 04 04 04 14 14 14 14 14 14 14 14 14 14 14 14 14 14 14 14 14 14 14 14 14 
14 03 04 04 04 04 04 04 04 04 04 04 04 14 14 14 04 04 04 04 04 04 04 04 04 04 04 04 14 14 14 14 14 14 14 14 14 14 14 14 14 14 14 14 14 14 14 14 14 14 
14 06 04 04 04 04 04 04 04 04 04 04 04 14 14 14 04 04 04 04 04 04 04 04 04 04 04 04 14 14 14 14 14 14 14 14 14 14 14 14 14 14 14 14 14 14 14 14 14 14 
14 14 06 04 04 04 04 04 04 04 04 04 04 14 14 14 04 04 04 04 04 04 04 04 04 04 04 04 14 14 14 14 14 14 14 14 14 14 14 14 14 14 14 14 14 14 14 14 14 14 
14 14 14 04 04 04 04 04 04 04 04 04 04 14 14 14 14 04 14 14 14 14 14 14 04 04 04 04 14 14 14 14 14 14 14 14 14 14 14 14 14 14 14 14 14 14 14 14 14 14 
14 14 00 04 04 04 04 04 04 04 04 04 04 14 14 04 04 04 14 14 14 14 14 14 04 04 04 04 04 14 14 14 14 14 14 14 14 14 14 14 14 14 14 14 14 14 14 14 14 14
14 00 04 04 04 04 04 04 04 04 04 04 04 14 14 04 14 14 14 14 14 14 14 14 04 04 04 04 04 04 14 14 14 14 14 14 14 14 14 14 14 14 14 14 14 14 14 14 14 14 
14 14 14 14 14 14 14 04 14 14 14 14 14 14 14 04 14 14 14 14 14 14 14 14 04 04 04 04 04 04 04 14 14 14 14 14 14 14 14 14 14 14 14 14 14 14 14 14 14 14 
14 14 14 14 14 14 14 04 14 14 14 14 14 14 14 04 14 14 14 14 14 14 14 14 04 04 04 04 04 04 04 04 14 14 14 14 14 14 14 14 14 14 14 14 14 14 14 14 14 14 
14 14 04 04 04 04 04 04 04 04 04 04 04 04 04 04 04 04 04 14 14 14 14 14 04 04 04 04 04 04 04 04 04 14 14 14 14 14 14 14 14 14 14 14 14 14 14 14 14 14 
14 14 04 04 04 04 04 04 04 04 04 04 04 04 04 04 04 04 04 04 04 14 14 14 04 04 04 04 04 04 04 04 04 04 14 14 14 14 14 14 14 14 14 14 14 14 14 14 14 14 
14 14 04 04 04 04 04 04 04 04 04 04 04 04 04 04 04 04 04 04 04 14 14 14 14 04 04 04 04 04 04 04 04 04 04 14 14 14 14 14 14 14 14 14 14 14 14 14 14 14 
14 14 04 04 04 04 04 04 04 04 04 04 04 04 04 04 04 04 04 04 04 14 14 14 14 04 04 04 04 04 04 04 04 04 04 14 14 14 14 14 14 14 14 14 14 14 14 14 14 14 
14 14 04 04 04 04 04 04 04 04 04 04 04 14 14 14 04 04 04 04 04 14 14 14 14 04 04 04 04 04 04 04 04 04 04 14 14 14 14 14 14 14 14 14 14 14 14 14 14 14 
14 14 04 04 04 04 04 04 04 04 04 04 04 14 14 14 04 04 04 04 04 14 14 14 04 04 04 04 04 04 04 04 04 04 04 04 14 14 14 14 14 14 14 14 14 14 14 14 14 14 
14 14 04 04 04 04 04 04 04 04 04 04 04 14 14 14 04 04 04 04 04 14 14 14 14 04 04 04 04 04 04 04 04 04 04 04 14 14 14 14 14 14 14 14 14 14 14 14 14 14 
14 14 04 04 04 04 04 04 04 04 04 04 04 04 04 04 04 04 04 04 04 14 14 14 14 04 04 04 04 04 04 04 04 04 04 14 14 14 14 14 14 14 14 14 14 14 14 14 14 14 
14 14 04 04 04 04 04 04 04 04 04 04 04 04 04 04 04 04 04 04 04 14 14 14 14 14 04 04 04 04 04 04 04 04 14 14 14 14 14 14 14 14 14 14 14 14 14 14 14 14 
14 14 04 04 04 04 04 04 04 04 04 04 04 04 04 04 04 04 04 04 04 14 14 14 14 14 14 04 04 04 04 04 04 14 14 14 14 14 14 14 14 14 14 14 14 14 14 14 14 14 
14 14 14 14 14 14 14 14 14 14 14 14 14 14 14 14 14 14 14 14 14 14 14 14 14 14 14 14 04 04 04 04 14 14 14 14 14 14 14 14 14 14 14 14 14 14 14 14 14 14 
14 14 14 14 14 14 14 14 14 14 14 14 14 14 14 14 14 14 14 14 14 14 14 14 14 14 14 14 14 04 04 14 14 14 14 14 14 14 14 14 14 14 14 14 14 14 14 14 14 14 
14 14 14 14 14 14 14 14 14 14 14 14 14 14 14 14 14 14 14 14 14 14 14 14 14 14 14 14 14 14 14 14 14 14 14 14 14 14 14 14 14 14 14 14 14 14 14 14 14 14 
14 14 14 14 14 14 14 14 14 14 14 14 14 14 14 14 14 14 14 14 14 14 14 14 14 14 14 14 14 14 14 14 14 14 14 14 14 14 14 14 14 14 14 14 14 14 14 14 14 14 
14 14 14 14 14 14 14 14 14 14 14 14 14 14 14 14 14 14 14 14 14 14 14 14 14 14 14 14 14 14 14 14 14 14 14 14 14 14 14 14 14 14 14 14 14 14 14 14 14 14 
14 14 14 14 14 14 14 14 14 14 14 14 14 14 14 14 14 14 14 14 14 14 14 14 14 14 14 14 14 14 14 14 14 14 14 14 14 14 14 14 14 14 14 14 14 14 14 14 14 14
14 14 14 14 14 14 14 14 14 14 14 14 14 14 14 14 14 14 14 14 14 14 14 14 14 14 14 14 14 14 14 14 14 14 14 14 14 14 14 14 14 14 14 14 14 14 14 14 14 14
14 14 14 14 14 14 14 14 14 14 14 14 14 14 14 14 14 14 14 14 14 14 14 14 14 14 14 14 14 14 14 14 14 14 14 14 14 14 14 14 14 14 14 14 14 14 14 14 14 14
14 14 14 14 14 14 14 14 14 14 14 14 14 14 14 14 14 14 14 14 14 14 14 14 14 14 14 14 14 14 14 14 14 14 14 14 14 14 14 14 14 14 14 14 14 14 14 14 14 14
14 14 14 14 14 14 14 14 14 14 14 14 14 14 14 14 14 14 14 14 14 14 14 14 14 14 14 14 14 14 14 14 14 14 14 14 14 14 14 14 14 14 14 14 14 14 14 14 14 14
14 14 14 14 14 14 14 14 14 14 14 14 14 14 14 14 14 14 14 14 14 14 14 14 14 14 14 14 14 14 14 14 14 14 14 14 14 14 14 14 14 14 14 14 14 14 14 14 14 14
14 14 14 14 14 14 14 14 14 14 14 14 14 14 14 14 14 14 14 14 14 14 14 14 14 14 14 14 14 14 14 14 14 14 14 14 14 14 14 14 14 14 14 14 14 14 14 14 14 14
14 14 14 14 14 14 14 14 14 14 14 14 14 14 14 14 14 14 14 14 14 14 14 14 14 14 14 14 14 14 14 14 14 14 14 14 14 14 14 14 14 14 14 14 14 14 14 14 14 14
14 14 14 14 14 14 14 14 14 14 14 14 14 14 14 14 14 14 14 14 14 14 14 14 14 14 14 14 14 14 14 14 14 14 14 14 14 14 14 14 14 14 14 14 14 14 14 14 14 14
14 14 14 14 14 14 14 14 14 14 14 14 14 14 14 14 14 14 14 14 14 14 14 14 14 14 14 14 14 14 14 14 14 14 14 14 14 14 14 14 14 14 14 14 14 14 14 14 14 14
14 14 14 14 14 14 14 14 14 14 14 14 14 14 14 14 14 14 14 14 14 14 14 14 14 14 14 14 14 14 14 14 14 14 14 14 14 14 14 14 14 14 14 14 14 14 14 14 14 14 
14 14 14 14 14 14 14 14 14 14 14 14 14 14 14 14 14 14 14 14 14 14 14 14 14 14 14 14 14 14 14 14 14 14 14 14 14 14 14 14 14 14 14 14 14 14 14 14 14 14